1
#################
#r.r.r.r.rrg.l.l#
##u.....r.####.u#
x##u...r.d.d.#.u#
xx##u.lsu.u.r.u.#
xxx##############