6
#######
#l.r.d#
#sr.u.#
#u.u.l#
#.g.l.#
#######