4
######
#.s..#
#.##.#
#.#g.#
#....#
######