3
########
#s.....#
#..#...#
#......#
#....#g#
########