4
######
#....#
#s##.#
#.#g.#
#....#
######