4
######
#s...#
#.##.#
#.#g.#
#....#
######