3
####xxxxx
#..##xxxx
#R.d###xx
#.#..d###
#.#....g#
#.#..####
#.#LL.#xx
#s...##xx
######xxx