3
##########
#........#
#s.......#
#........#
#..R.....#
#........#
#.....#g.#
#........#
##########