3
#########
#.......#
#...#g..#
#...#...#
#..U....#
#.s.....#
#########