4
#############
#...........#
#......D....#
#......D..s.#
#...........#
#...#########
#..g#xxxxxxxx
#...#xxxxxxxx
#####xxxxxxxx