4
#############
#...........#
#......D....#
#......D..s.#
#.....U.....#
#...#########
#..g#xxxxxxxx
#...#xxxxxxxx
#####xxxxxxxx