1
##########
#s..D...g#
####.###.#
xxx#.###.#
xxx#R...U#
xxx#######