3
#########
#.......#
#.b.b.b.#
#.gb.b..#
#.b.b.b.#
#..bsb..#
#.b.b.b.#
#.......#
#########