3
###############
#.............#
#.............#
#.....B......g#
#.............#
#.............#
#s............#
###############