6
x#####x
x#g..#x
####.##
#s..b.#
##...##
x#####x