5
....####....
..###..####.
..#.s....g#.
..#.....###.
..#######...