6
..####xx########
###..####.n....#
#.sburldb.###..#
#URLDB###.#x#..#
#.....#x#.###..#
#.....#x#.....g#
#######x########