5
....####xx########
..###..####.n....#
..#.s.urldb.###..#
..#URLDR###.#x#..#
..#.....#x#.###..#
..#.....#x#.....g#
..#######x########